0000000000000000000011111
0002000000000000000011111
1000000000000000000011111
1111111111111111111111111
1000000000000000000011111
1000000000000000000011111
1111111111111111111111111
1000000000000000000011111
1000000000000000000011111
1000000000111111111111111
1000000000000000000000000
1000000000000000000000000
1000000000000000000000000
1000000000000000000000000
1000000000000000000003000
1111111111111111111111111
1111111111111111111111111
1111111111111111111111111
