1000000000000000000011111
1002000000000000000011111
1000000000000000000011111
1000000000000000000011111
1111111111110000000011111
1111111111110000000011111
1111111111110000000011111
1000000000000000000011111
1111110000000000000011111
1000000000000000000011111
1000000000000000000011111
1000000000000000000000000
1000000000000000000003000
1000000000000000000011000
1000000000000000000010000
1111111111111111111111111
1111111111111111111111111
1111111111111111111111111
