1000000000000000000011111
1000000000000000000011111
1000000000000000000011111
1000000000000000000011111
1111111111110000000011111
1111111111110000000011111
1111111111110000000011111
1000000000000000000011111
1000000000000000000011111
1000000000000000000011111
1000000000000000000011111
1000000000000000000000000
1000000000000000000000000
1000000000000000000000000
1000000000000000000000000
1111111111111111111111111
1111111111111111111111111
1111111111111111111111111
